000011120001000
022122121220220
112021111020201
201111222011102
112021111121211
122021222121221
111101222110100
022121222120221
002121110121211
201101222110102
112021110121200
022122121221220
000110020010000