22222222222222222
20000111200010002
20221221212202202
21120211110202012
22011112220111022
21120211111212112
21220212221212212
21111012221101002
20221212221202212
20021211101212112
22011012221101022
21120211101212002
20221221212212202
20001100200100002
22222222222222222
