77777777777777777
70065260706063007
70772770747767707
76732076767026747
76467074707076537
77767706260774777
76646067776062507
74767727772776767
76060667776034207
77767706260776777
70247670707073447
76700676767460767
70774770707707707
70036600746066007
77777777777777777
