55555555555555555
50000111500010005
50551551515505505
51150511110505015
55011115550111055
51150511111515115
51550515551515515
51111015551101005
50551515551505515
50051511111515115
55011015551101055
51150511101515005
50551551515515505
50001100500100005
55555555555555555