77777777777777777
70030131700113007
70773771717747707
73172711130707217
77051117770135077
71370745554717117
74770757775717717
73113057775101007
70771757775707737
70072745554737417
77351017771105177
71270714101717037
70773773717717707
70031200700102007
77777777777777777