77777777777777777
70000111700010007
70771771717707707
71170711110707017
77011117770111077
71170711111717117
71770717771717717
71111017771101007
70771717771707717
70071711111717117
77011017771101077
71170711101717007
70771771717717707
70001100700100007
77777777777777777